"filename", "language", "HTML", "CSS", "comment", "blank", "total"
"c:\Users\24343\Desktop\互联网应用开发基础训练\最终版\final edition-全中文\v3.3\html\C++参考_中文.html", "HTML", 75, 0, 0, 1, 76
"c:\Users\24343\Desktop\互联网应用开发基础训练\最终版\final edition-全中文\v3.3\html\C参考_中文.html", "HTML", 75, 0, 0, 1, 76
"c:\Users\24343\Desktop\互联网应用开发基础训练\最终版\final edition-全中文\v3.3\html\c++参考_二级目录\c++_algorithm_中文.html", "HTML", 156, 0, 0, 1, 157
"c:\Users\24343\Desktop\互联网应用开发基础训练\最终版\final edition-全中文\v3.3\html\c++参考_二级目录\c++_map_中文.html", "HTML", 162, 0, 0, 1, 163
"c:\Users\24343\Desktop\互联网应用开发基础训练\最终版\final edition-全中文\v3.3\html\c++参考_二级目录\c++_queue_中文.html", "HTML", 112, 0, 0, 1, 113
"c:\Users\24343\Desktop\互联网应用开发基础训练\最终版\final edition-全中文\v3.3\html\c++参考_二级目录\c++_stack_中文.html", "HTML", 115, 0, 0, 1, 116
"c:\Users\24343\Desktop\互联网应用开发基础训练\最终版\final edition-全中文\v3.3\html\c++参考_二级目录\c++_string_中文.html", "HTML", 187, 0, 0, 1, 188
"c:\Users\24343\Desktop\互联网应用开发基础训练\最终版\final edition-全中文\v3.3\html\c++参考_二级目录\c++_vector_中文.html", "HTML", 177, 0, 0, 2, 179
"c:\Users\24343\Desktop\互联网应用开发基础训练\最终版\final edition-全中文\v3.3\html\c参考_二级目录\c_ctype_中文.html", "HTML", 165, 0, 0, 5, 170
"c:\Users\24343\Desktop\互联网应用开发基础训练\最终版\final edition-全中文\v3.3\html\c参考_二级目录\c_math_中文.html", "HTML", 223, 0, 0, 6, 229
"c:\Users\24343\Desktop\互联网应用开发基础训练\最终版\final edition-全中文\v3.3\html\c参考_二级目录\c_stdio_中文.html", "HTML", 347, 0, 0, 1, 348
"c:\Users\24343\Desktop\互联网应用开发基础训练\最终版\final edition-全中文\v3.3\html\c参考_二级目录\c_stdlib_中文.html", "HTML", 210, 0, 0, 6, 216
"c:\Users\24343\Desktop\互联网应用开发基础训练\最终版\final edition-全中文\v3.3\html\c参考_二级目录\c_string_中文.html", "HTML", 195, 0, 0, 13, 208
"c:\Users\24343\Desktop\互联网应用开发基础训练\最终版\final edition-全中文\v3.3\html\c参考_二级目录\c_time_中文.html", "HTML", 215, 0, 0, 2, 217
"c:\Users\24343\Desktop\互联网应用开发基础训练\最终版\final edition-全中文\v3.3\html\后台.html", "HTML", 69, 0, 0, 5, 74
"c:\Users\24343\Desktop\互联网应用开发基础训练\最终版\final edition-全中文\v3.3\html\学习资源_中文.html", "HTML", 146, 0, 0, 0, 146
"c:\Users\24343\Desktop\互联网应用开发基础训练\最终版\final edition-全中文\v3.3\html\开发平台_中文.html", "HTML", 116, 0, 5, 1, 122
"c:\Users\24343\Desktop\互联网应用开发基础训练\最终版\final edition-全中文\v3.3\html\开发平台二级目录\CodeBlocks.html", "HTML", 174, 0, 0, 8, 182
"c:\Users\24343\Desktop\互联网应用开发基础训练\最终版\final edition-全中文\v3.3\html\开发平台二级目录\Dev_c++.html", "HTML", 179, 0, 0, 2, 181
"c:\Users\24343\Desktop\互联网应用开发基础训练\最终版\final edition-全中文\v3.3\html\开发平台二级目录\VS.html", "HTML", 166, 0, 0, 3, 169
"c:\Users\24343\Desktop\互联网应用开发基础训练\最终版\final edition-全中文\v3.3\html\开发平台二级目录\VScode.html", "HTML", 173, 0, 0, 3, 176
"c:\Users\24343\Desktop\互联网应用开发基础训练\最终版\final edition-全中文\v3.3\html\开发平台二级目录\Xcode.html", "HTML", 137, 0, 0, 4, 141
"c:\Users\24343\Desktop\互联网应用开发基础训练\最终版\final edition-全中文\v3.3\html\成员介绍_中文.html", "HTML", 185, 0, 0, 4, 189
"c:\Users\24343\Desktop\互联网应用开发基础训练\最终版\final edition-全中文\v3.3\html\注册界面_中文.html", "HTML", 152, 0, 0, 5, 157
"c:\Users\24343\Desktop\互联网应用开发基础训练\最终版\final edition-全中文\v3.3\html\注册界面_英文.html", "HTML", 152, 0, 0, 5, 157
"c:\Users\24343\Desktop\互联网应用开发基础训练\最终版\final edition-全中文\v3.3\html\登录界面_中文.html", "HTML", 118, 0, 0, 3, 121
"c:\Users\24343\Desktop\互联网应用开发基础训练\最终版\final edition-全中文\v3.3\html\登录界面_英文.html", "HTML", 118, 0, 0, 3, 121
"c:\Users\24343\Desktop\互联网应用开发基础训练\最终版\final edition-全中文\v3.3\html\训练题单.html", "HTML", 163, 0, 1, 0, 164
"c:\Users\24343\Desktop\互联网应用开发基础训练\最终版\final edition-全中文\v3.3\html\训练题单基础\c基础_函数.html", "HTML", 273, 0, 1, 31, 305
"c:\Users\24343\Desktop\互联网应用开发基础训练\最终版\final edition-全中文\v3.3\html\训练题单基础\c基础_数组.html", "HTML", 273, 0, 1, 31, 305
"c:\Users\24343\Desktop\互联网应用开发基础训练\最终版\final edition-全中文\v3.3\html\训练题单基础\基本数据类型.html", "HTML", 272, 0, 1, 30, 303
"c:\Users\24343\Desktop\互联网应用开发基础训练\最终版\final edition-全中文\v3.3\html\训练题单基础\基本表达式运算.html", "HTML", 273, 0, 1, 31, 305
"c:\Users\24343\Desktop\互联网应用开发基础训练\最终版\final edition-全中文\v3.3\html\训练题单基础\循环控制语句.html", "HTML", 291, 0, 1, 31, 323
"c:\Users\24343\Desktop\互联网应用开发基础训练\最终版\final edition-全中文\v3.3\html\训练题单基础\简单二进制应用.html", "HTML", 254, 0, 1, 32, 287
"c:\Users\24343\Desktop\互联网应用开发基础训练\最终版\final edition-全中文\v3.3\html\训练题单答案.html", "HTML", 172, 0, 0, 2, 174
"c:\Users\24343\Desktop\互联网应用开发基础训练\最终版\final edition-全中文\v3.3\html\训练题单进阶\函数递归.html", "HTML", 255, 0, 1, 32, 288
"c:\Users\24343\Desktop\互联网应用开发基础训练\最终版\final edition-全中文\v3.3\html\训练题单进阶\基本数据结构.html", "HTML", 272, 0, 1, 31, 304
"c:\Users\24343\Desktop\互联网应用开发基础训练\最终版\final edition-全中文\v3.3\html\训练题单进阶\字符串.html", "HTML", 273, 0, 1, 31, 305
"c:\Users\24343\Desktop\互联网应用开发基础训练\最终版\final edition-全中文\v3.3\html\训练题单进阶\指针基础应用.html", "HTML", 273, 0, 1, 31, 305
"c:\Users\24343\Desktop\互联网应用开发基础训练\最终版\final edition-全中文\v3.3\html\训练题单进阶\指针进阶应用.html", "HTML", 273, 0, 1, 31, 305
"c:\Users\24343\Desktop\互联网应用开发基础训练\最终版\final edition-全中文\v3.3\html\训练题单进阶\数组.html", "HTML", 255, 0, 1, 31, 287
"c:\Users\24343\Desktop\互联网应用开发基础训练\最终版\final edition-全中文\v3.3\html\语言简介二级目录\发展历史_中文.html", "HTML", 76, 0, 1, 2, 79
"c:\Users\24343\Desktop\互联网应用开发基础训练\最终版\final edition-全中文\v3.3\html\语言简介二级目录\简介_中文.html", "HTML", 84, 0, 1, 2, 87
"c:\Users\24343\Desktop\互联网应用开发基础训练\最终版\final edition-全中文\v3.3\html\项目介绍_中文.html", "HTML", 86, 0, 1, 7, 94
"c:\Users\24343\Desktop\互联网应用开发基础训练\最终版\final edition-全中文\v3.3\index.html", "HTML", 56, 0, 1, 1, 58
"c:\Users\24343\Desktop\互联网应用开发基础训练\最终版\final edition-全中文\v3.3\style\c-c++参考.css", "CSS", 0, 53, 0, 8, 61
"c:\Users\24343\Desktop\互联网应用开发基础训练\最终版\final edition-全中文\v3.3\style\c_c++参考页面图片文字.css", "CSS", 0, 21, 0, 1, 22
"c:\Users\24343\Desktop\互联网应用开发基础训练\最终版\final edition-全中文\v3.3\style\index.css", "CSS", 0, 91, 0, 20, 111
"c:\Users\24343\Desktop\互联网应用开发基础训练\最终版\final edition-全中文\v3.3\style\intro.css", "CSS", 0, 34, 0, 6, 40
"c:\Users\24343\Desktop\互联网应用开发基础训练\最终版\final edition-全中文\v3.3\style\sources.css", "CSS", 0, 12, 0, 2, 14
"c:\Users\24343\Desktop\互联网应用开发基础训练\最终版\final edition-全中文\v3.3\style\关于我们.css", "CSS", 0, 84, 0, 10, 94
"c:\Users\24343\Desktop\互联网应用开发基础训练\最终版\final edition-全中文\v3.3\style\开发平台.css", "CSS", 0, 66, 0, 4, 70
"c:\Users\24343\Desktop\互联网应用开发基础训练\最终版\final edition-全中文\v3.3\style\注册界面.css", "CSS", 0, 57, 0, 2, 59
"c:\Users\24343\Desktop\互联网应用开发基础训练\最终版\final edition-全中文\v3.3\style\题单.css", "CSS", 0, 79, 0, 12, 91
"Total", "-", 8173, 497, 22, 540, 9232